32/32/431/208/16/16/0/1/0/100;
32/32/448/160/0/0/1/1/1/0;
32/32/416/160/0/0/1/1/1/0;
32/32/448/192/0/0/1/1/1/0;
32/32/448/224/0/0/1/1/1/0;
32/32/416/224/0/0/1/1/1/0;
